"a" = (/turf,/area)
"b" = (/turf/Floors/Wood_Floor,/area/exercise_room)
"c" = (/obj/Exercise_Equipment/Treadmill,/turf/Floors/Wood_Floor,/area/exercise_room)
"d" = (/obj/Exercise_Equipment/Barbell,/turf/Floors/Wood_Floor,/area/exercise_room)
"e" = (/mob/npc/Trainer,/turf/Floors/Wood_Floor,/area/exercise_room)
"f" = (/obj/Vending_Machine,/turf/Floors/Wood_Floor,/area/exercise_room)
"g" = (/turf,/area/spooky_area)
"h" = (/obj/Billboard,/turf/Floors/Wood_Floor,/area/exercise_room)

(1,1,1) = {"
aaaaaaaaaaaaaaaaaaaaaaaaaaaaaaaaaaaaaaaaaaaaaaaaaa
aaaaaaaaaaaaaaaaaaaaaaaaaaaaaaaaaaaaaaaaaaaaaaaaaa
ggggggggggggggggggggggggggggggggggggggggggggaaaaaa
ggggggggggggggggggggggggggggggggggggggggggggaaaaaa
ggggggggggggggggggggggggggggggggggggggggggggaaaaaa
ggggggggggggggggggggggggggggggggggggggggggggaaaaaa
ggggggggggggggggggggggggggggggggggggggggggggaaaaaa
ggggggggggggggggggggggggggggggggggggggggggggaaaaaa
ggggggggggggggggggggggggggggggggggggggggggggaaaaaa
ggggggggggggggggggggggggggggggggggggggggggggaaaaaa
ggggggggggggggggggggggggggggggggggggggggggggaaaaaa
ggggggggggggggggggggggggggggggggggggggggggggaaaaaa
ggggggggggggggggggggggggggggggggggggggggggggaaaaaa
ggggggggggggggggggggggggggggggggggggggggggggaaaaaa
ggggggggggggggggggggggggggggggggggggggggggggaaaaaa
ggggggggggggggggggggggggggggggggggggggggggggaaaaaa
ggggggggggggggggggggggggggggggggggggggggggggaaaaaa
ggggggggggggggggggggggggggggggggggggggggggggaaaaaa
ggggggggggggggggggggggggggggggggggggggggggggaaaaaa
ggggggggggggggggggggggggggggggggggggggggggggaaaaaa
ggggggggggggggggggggggggggggggggggggggggggggaaaaaa
ggggggggggggggggggggggggggggggggggggggggggggaaaaaa
ggggggggggggggggggggggggggggggggggggggggggggaaaaaa
ggggggggggggggggggggggggggggggggggggggggggggaaaaaa
ggggggggggggggggggggggggggggggggggggggggggggaaaaaa
ggggggggggggggggggggggggggggggggggggggggggggaaaaaa
ggggggggggggggggggggggggggggggggggggggggggggaaaaaa
ggggggggggggggggggggggggggggggggggggggggggggaaaaaa
ggggggggggggggggggggggggggggggggggggggggggggaaaaaa
ggggggggggggggggggggggggggggggggggggggggggggaaaaaa
bbbbbbbbbbbbbbbbbbbbbbgggggggggggggggggggggggggggg
bbbbbbbbbbbbbbbbbbbbbbgggggggggggggggggggggggggggg
bbbbbbbbbbbbbbbbbbbbbbgggggggggggggggggggggggggggg
bbbbbbbbbbbbbbbbbbbbbbgggggggggggggggggggggggggggg
bbbbbbbbbbbbbbbbbbbbbbgggggggggggggggggggggggggggg
bbbbbbbbbbbbbbbbbbbbbbgggggggggggggggggggggggggggg
bbbbbbbbbbbbbbbbbbbbbbgggggggggggggggggggggggggggg
bbbbbbbbbbbbbbbbbbbbbbgggggggggggggggggggggggggggg
bbbbbbbbbbbbbbbbbbbbbbgggggggggggggggggggggggggggg
bbbbbbbbbbbbbbbbbbbbbbgggggggggggggggggggggggggggg
bbbbbcbbbbbbbdbbbbbbbbgggggggggggggggggggggggggggg
bbbbbbbbbbbbbbbbbbbbbbgggggggggggggggggggggggggggg
bbbbbbbbbbbbbbbbbbbbbbgggggggggggggggggggggggggggg
bbbbbbbbbbbbbbbbbbbbbbgggggggggggggggggggggggggggg
bbhbbbbbbbbbbbbbbbbbbbgggggggggggggggggggggggggggg
bbbbbbbbbebbbbbbfbbbbbgggggggggggggggggggggggggggg
bbbbbbbbbbbbbbbbbbbbbbgggggggggggggggggggggggggggg
bbbbbbbbbbbbbbbbbbbbbbgggggggggggggggggggggggggggg
bbbbbbbbbbbbbbbbbbbbbbgggggggggggggggggggggggggggg
bbbbbbbbbbbbbbbbbbbbbbgggggggggggggggggggggggggggg
"}
